25x25
1111111111111111111111111
1000000000000000000000011
1011111111101111110111011
1000000111101111110111011
1000000111100000000000001
1111110111101111111011011
1111110111101111113011111
1111110111101111111011111
1001110000000011110011111
1011111011110000011111111
1011111011111111000000011
1040000000000000001111011
1111101111101110111111001
1000001000001110011111101
1010111011101111011111101
1010111030000000000000001
1000000000001111111101111
1011111111031111111100001
1011111111011111111111101
1000001111000000003000001
1011001111111111113011111
1011101111111111110011111
1011101111111111000301111
1000000000002000030000001
1111111111111111111111111