20x13
11111111111111111111
12222122222222122221
12112121122112122221
12122222122122222121
12121121122112222121
12222222333312122221
12122221111112122121
12122221222212122121
12122221011112122121
10100000000000100101
10110101111110101101
10000100040000100001
11111111111111111111