20x11
11111111111111111111
12222122222222122221
12112121111112121121
12122222222222222121
12121121100112112121
12222221033012222221
12121121122112112121
12122222222222222121
12112121111112121121
12222122242222122221
11111111111111111111