20x7
11111111111111111111
12222221000012222221
12112221100112221121
12122123222232122121
12112121111112121121
12222222224222222221
11111111111111111111